{
  "name": "sig.tmpl.teal",
  "version": 5,
  "template_labels": {
    "TMPL_ADDR_IDX": { "source_line": 4, "position": 52, "bytes": false },
    "TMPL_EMITTER_ID": { "source_line": 6, "position": 55, "bytes": true }
  },
  "line_map": [
    0, 1, 7, 51, 53, 54, 56, 57, 59, 60, 61, 64, 65, 68, 0, 69, 72, 75, 76, 0,
    77, 78, 0, 79, 82, 83, 84, 87, 88, 89, 90, 93, 99, 100, 101, 104, 105, 106,
    107, 110, 111, 112, 113, 116, 117, 118, 119, 120, 0, 121, 124, 125, 126,
    129, 130, 131, 132, 135, 136, 137, 138, 139, 142, 143, 144, 145, 148, 149,
    150, 151, 154, 155, 156, 157, 160, 161, 162, 163, 166, 167, 168, 169
  ]
}
